8

0 0 0 0 0 0 0 0 0 0 0 0 0 0 0 0 0 0 0 0
0 0 0 0 0 0 0 0 0 0 0 0 0 0 0 0 0 0 0 0
0 0 0 0 0 0 0 0 0 0 0 0 0 0 0 0 0 0 0 0
0 0 0 0 0 0 0 0 0 0 0 0 0 0 0 0 0 0 0 0
0 0 0 0 0 0 0 0 0 0 0 0 0 0 0 0 0 0 0 0
1 1 1 3 1 1 1 4 1 1 1 1 2 1 1 1 2 1 5 1
0 0 0 0 0 0 0 0 0 0 0 0 0 0 0 0 0 0 0 0
0 0 0 0 0 0 0 0 0 0 0 0 0 0 0 0 0 0 0 0

0 0 0 0 0 0 0 1 2 1 0 0 0 0 0 0 0 0 0 0
0 0 0 0 0 0 0 1 0 1 0 0 0 0 0 0 0 0 0 0
0 0 0 0 0 1 2 1 0 1 1 1 0 0 0 0 0 0 0 0
0 0 0 0 0 5 0 0 0 0 0 1 0 0 0 0 0 0 0 0
0 0 0 0 0 1 0 0 0 0 0 3 0 0 0 0 0 0 0 0
1 1 1 3 1 1 0 0 0 0 0 1 0 1 1 4 1 1 1 1
0 0 0 0 0 0 0 0 0 0 0 5 0 1 0 0 0 0 0 0
0 0 0 0 0 0 0 0 0 0 0 1 3 1 0 0 0 0 0 0

0 1 1 3 3 4 4 3 3 1 0 0 0 0 0 0 0 0 0 0
0 5 0 0 0 0 0 0 0 1 0 0 0 0 0 0 0 0 0 0
0 1 0 1 1 1 3 1 0 3 0 0 0 0 0 0 0 0 0 0
0 1 1 1 0 0 0 1 0 3 0 0 0 0 0 0 0 0 0 0
0 0 0 0 0 0 0 1 0 1 0 0 0 0 0 0 0 0 0 0
1 1 1 1 1 3 1 1 1 1 0 0 0 0 1 1 2 5 1 1
0 0 0 0 0 0 0 5 0 0 0 0 0 0 1 0 0 0 0 0
0 0 0 0 0 0 0 1 1 2 1 1 1 3 1 0 0 0 0 0

0 0 0 3 1 1 2 1 1 0 0 0 3 1 5 1 3 1 0 0
0 1 3 3 0 0 0 0 1 0 0 0 1 0 0 0 0 1 0 0
0 1 0 0 0 0 0 0 5 0 1 1 1 1 1 2 1 1 0 0
0 2 0 0 1 3 3 1 1 0 3 0 1 0 0 0 0 0 0 0
0 1 0 0 1 0 0 0 0 0 1 1 2 1 5 3 3 1 0 0
1 1 0 0 1 1 0 0 0 0 0 0 1 0 0 0 0 1 1 1
0 0 0 0 0 1 1 4 1 1 2 1 1 0 0 0 0 0 0 0
0 0 0 0 0 0 0 0 0 0 0 0 0 0 0 0 0 0 0 0

0 0 0 0 0 0 0 0 0 0 0 0 0 0 0 0 0 0 0 0
0 0 0 0 0 0 1 2 1 0 0 0 0 0 0 0 0 0 0 0
0 0 0 0 0 0 4 0 5 0 0 0 0 0 0 0 0 0 0 0
0 0 0 0 0 0 4 0 3 0 0 1 1 3 3 2 1 0 0 0
0 0 0 0 0 0 3 0 2 0 0 1 0 0 0 0 1 5 1 0
1 1 1 1 0 0 3 0 1 1 3 1 0 0 0 0 0 0 1 1
0 0 0 3 1 1 1 0 0 0 0 0 0 0 0 0 0 0 0 0
0 0 0 0 0 0 0 0 0 0 0 0 0 0 0 0 0 0 0 0

0 0 0 0 1 2 1 0 0 0 0 0 0 0 0 0 0 0 0 0
0 0 0 0 4 0 1 0 0 3 1 5 1 2 1 1 1 0 0 0
0 0 0 0 4 0 5 0 0 3 0 0 0 0 0 0 1 0 0 0
0 0 1 3 3 3 1 0 0 4 0 0 0 0 0 0 2 0 0 0
0 0 1 0 1 0 0 0 0 4 0 0 0 0 0 0 1 0 0 0
1 1 1 2 1 0 0 0 0 3 0 0 0 0 0 0 1 5 3 1
0 0 1 0 0 0 0 0 0 3 0 0 0 0 0 0 0 0 0 0
0 0 2 1 1 2 1 2 1 1 0 0 0 0 0 0 0 0 0 0

0 0 0 0 1 2 1 0 0 0 0 0 0 0 0 0 0 0 0 0
0 0 0 0 1 0 1 0 0 0 0 1 3 3 4 1 1 0 0 0
0 0 3 1 2 1 1 0 0 0 0 5 0 0 0 0 1 0 0 0
0 0 1 0 1 0 0 0 0 0 0 1 0 0 0 0 3 0 0 0
0 0 1 0 1 0 1 2 1 1 4 3 0 0 0 0 1 0 0 0
1 1 2 1 1 0 3 0 0 0 0 0 0 0 0 0 5 2 1 1
0 0 1 0 0 0 1 0 0 0 0 0 0 0 0 0 0 0 0 0
0 0 5 1 3 1 1 0 0 0 0 0 0 0 0 0 0 0 0 0

0 0 0 0 1 1 3 3 2 1 1 4 4 1 5 1 2 1 0 0
0 0 0 0 3 0 0 0 0 0 0 0 0 0 0 0 0 1 0 0
0 0 4 3 3 3 1 1 2 1 5 1 2 1 1 3 1 1 0 0
0 0 3 0 1 0 0 0 0 0 0 0 0 0 0 0 0 0 0 0
0 0 3 1 1 5 1 0 0 1 1 2 1 0 0 0 0 0 0 0
1 1 0 0 1 0 2 0 0 3 0 0 5 0 0 0 0 1 5 1
0 1 0 0 1 0 1 0 0 3 0 0 1 1 1 4 3 1 0 0
0 1 2 1 1 0 1 1 2 1 0 0 0 0 0 0 0 0 0 0